0,0,0,0,0,0,0,0,0,0,0,0
0,$R:400,,,,,,,,,B,0
0,0,0,0,0,0,0,0,0,0,0,0
1,1,1,1,1,1,1,1,1,1,1,1
1,b,,,,,,,@,1,1,1
1,1,,1,,1,,1,1,1,1,1
1,1,,1,,1,,,@,1,1,1
1,1,,1,,1,0,1,1,1,1,1
1,1,,1,,,,,@,1,1,1
1,1,,1,0,1,,1,1,1,1,1
1,1,,1,1,1,,,@,1,1,1
1,1,,1,1,1,0,1,1,1,1,1
1,1,,,,,,,@,1,1,1
1,1,0,1,,1,,1,1,1,1,1
1,1,1,1,,1,,,@,1,1,1
1,1,1,1,,1,0,1,1,1,1,1
1,1,1,1,,,,,@,1,1,1
1,1,1,1,0,1,,1,1,1,1,1
1,1,1,1,1,1,,,@,1,1,1
1,1,1,1,1,1,0,1,1,1,1,1