0,0,0,0,0,0,0,0,0
0,0,g,0,c,0,i,0,0
0,a,0,K,,E,0,h,0
0,0,A,0,D,0,H,0,0
0,$R:20,,C,0,I,,@,0
0,0,B,0,J,0,j,0,0
0,E,0,G,,F,0,f,0
0,0,d,0,k,0,b,0,0
0,0,0,0,0,0,0,0,0