1,1,1,1,1,1,1,1,1,1,1,1,1,1,1
1,1,,,,|:7:+-:--,|:6:+-:--,|:5:+-:--,|:4:+-:--,|:3:+-:--,|:2:+-:--,|:1:+-:--,|:0:+-:--,,1
1,1,,1,1,1,1,1,1,1,1,1,1,,1
1,1,,|:7:--:+-,,|:6:+-:--,|:5:+-:--,|:4:+-:--,|:3:+-:--,|:2:+-:--,|:1:+-:--,|:0:+-:--,,,1
1,1,,1,1,1,1,1,1,1,1,1,1,,1
1,1,,|:6:--:+-,,|:5:+-:--,|:4:+-:--,|:3:+-:--,|:2:+-:--,|:1:+-:--,|:0:+-:--,,,,1
1,1,,1,1,1,1,1,1,1,1,1,1,,1
1,1,,|:5:--:+-,,|:4:+-:--,|:3:+-:--,|:2:+-:--,|:1:+-:--,|:0:+-:--,,,,,1
1,1,,1,1,1,1,1,1,1,1,1,1,,1
1,1,,|:4:--:+-,,|:3:+-:--,|:2:+-:--,|:1:+-:--,|:0:+-:--,,,,,,1
1,1,,1,1,1,1,1,1,1,1,1,1,,1
1,1,,|:3:--:+-,,|:2:+-:--,|:1:+-:--,|:0:+-:--,,,,,,,1
1,1,,1,1,1,1,1,1,1,1,1,1,,1
1,1,,|:2:--:+-,,|:1:+-:--,|:0:+-:--,,,,,,,,1
1,1,,1,1,1,1,1,1,1,1,1,1,,1
1,1,,|:1:--:+-,,|:0:+-:--,,,,,,,,,1
1,1,,1,1,1,1,1,1,1,1,1,1,,1
1,1,,|:0:--:+-,,,,,,,,,,@,1
1,$R:150,,1,1,1,1,1,1,1,1,1,1,0,1
1,1,|:0:--:-+,1,1,1,1,1,1,1,1,1,1,1,1
1,1,,1,1,1,1,1,1,1,1,1,1,1,1
1,1,|:1:--:-+,1,1,1,1,1,1,1,1,1,1,1,1
1,1,,1,1,1,1,1,1,1,1,1,1,1,1
1,1,|:2:--:-+,1,1,1,1,1,1,1,1,1,1,1,1
1,1,,1,1,1,1,1,1,1,1,1,1,1,1
1,1,|:3:--:-+,1,1,1,1,1,1,1,1,1,1,1,1
1,1,,1,1,1,1,1,1,1,1,1,1,1,1
1,1,|:4:--:-+,1,1,1,1,1,1,1,1,1,1,1,1
1,1,,1,1,1,1,1,1,1,1,1,1,1,1
1,1,|:5:--:-+,1,1,1,1,1,1,1,1,1,1,1,1
1,1,,1,1,1,1,1,1,1,1,1,1,1,1
1,1,|:6:--:-+,1,1,1,1,1,1,1,1,1,1,1,1
1,1,,1,1,1,1,1,1,1,1,1,1,1,1
1,1,|:7:--:-+,1,1,1,1,1,1,1,1,1,1,1,1
1,1,,1,1,1,1,1,1,1,1,1,1,1,1
1,1,,1,1,1,1,1,1,1,1,1,1,1,1
1,1,1,1,1,1,1,1,1,1,1,1,1,1,1