1,1,1,1,1,1,1,1,1,1,1,1,1,1,1,1,1,1,1,1,1,1
1,1,A,1,1,1,A,1,1,1,A,1,1,1,A,1,1,1,A,1,1,1
1,1,|:0:+-:--,1,1,1,|:2:+-:--,1,1,1,|:4:+-:--,1,1,1,|:6:+-:--,1,1,1,,1,b,1
1,$R:500,,|:0:--:++,,|:1:--:++,,|:2:--:++,,|:3:--:++,,|:4:--:++,,|:5:--:++,,|:6:--:++,,|:7:--:++,,0,@,1
1,1,1,1,|:1:+-:--,1,1,1,|:3:+-:--,1,1,1,|:5:+-:--,1,1,1,|:7:+-:--,1,1,1,a,1
1,1,1,1,B,1,1,1,B,1,1,1,B,1,1,1,B,1,1,1,1,1
1,1,1,1,1,1,1,1,1,1,1,1,1,1,1,1,1,1,1,1,1,1