1,1,1,1,1,1,1,1,1,1,1,1,1,1,1,1,1,1,1,1
1,A,1,A,1,A,1,A,1,A,1,1,1,1,1,1,1,1,1,1
1,,1,|:6:+-:--,1,|:4:+-:--,1,|:2:+-:--,1,|:0:+-:--,1,1,1,1,1,1,1,1,1,1
1,|:7:--:+-,|:6:--:+-,|:5:--:+-,|:4:--:+-,|:3:--:+-,|:2:--:+-,|:1:--:+-,|:0:--:+-,$R:500,|:0:--:++,|:1:--:++,|:2:--:++,|:3:--:++,|:4:--:++,|:5:--:++,|:6:--:++,|:7:--:++,0,1
1,1,|:7:+-:--,1,|:5:+-:--,1,|:3:+-:--,1,|:1:+-:--,1,1,1,1,1,1,1,1,1,1,1
1,1,B,1,B,1,B,1,B,1,a,@,b,1,1,1,1,1,1,1
1,1,1,1,1,1,1,1,1,1,1,1,1,1,1,1,1,1,1,1