0,0,0,0,0,0,0,0,0,0,0,0,0,0,0,0,0,0,0,0,0,0,0,0,0,0,0,0,0,0,0,0
1,$R:1500,,,,,,,,,,,,,,,,,,,,,,,,,,,,,,0
1,1,,1,1,,1,1,,1,1,,1,1,,1,1,,1,1,,0,1,,1,1,,1,1,,1,1
1,1,,1,1,,1,1,,0,1,,1,1,,1,1,,1,1,,1,1,,1,1,,1,1,,1,1
1,0,,1,1,,1,1,,1,1,,1,1,,1,1,,1,1,,1,1,,1,1,,1,1,,1,1
1,1,,1,1,,1,1,,1,1,,1,1,,1,1,,1,1,,1,1,,1,1,,0,1,,1,1
1,1,,0,1,,1,1,,1,1,,1,0,,0,1,,1,1,,1,1,,1,1,,1,1,,1,1
1,1,,1,1,,1,1,,1,1,,1,1,,1,1,,1,1,,1,1,,1,0,,1,1,,1,1
1,1,0,1,1,,1,1,,1,1,,1,1,,1,1,,1,1,,1,1,,1,1,,1,1,,1,1
1,1,1,1,1,,1,1,,1,1,,1,1,,1,1,,1,1,,1,1,,1,1,,1,1,,1,1
1,1,1,1,1,,1,1,,1,1,,1,1,0,1,1,,1,1,,1,1,,1,1,,1,1,,1,1
1,1,1,1,1,,1,1,,1,1,,1,1,1,1,1,,1,1,,1,1,,1,1,0,1,1,,1,1
1,1,1,1,1,,1,0,,1,1,,1,1,1,1,1,,1,1,,1,1,,1,1,1,1,1,,1,1
1,1,1,1,1,,1,1,,1,1,,1,1,1,1,1,,1,1,,1,1,,1,1,1,1,1,,1,1
1,1,1,1,1,,1,1,0,1,1,,1,1,1,1,1,,1,1,,1,1,,1,1,1,1,1,,1,1
1,1,1,1,1,@,1,1,1,1,1,,1,1,1,1,1,,1,0,,1,1,,1,1,1,1,1,,1,1
1,1,1,1,1,1,1,1,1,1,1,,1,1,1,1,1,,1,1,0,1,1,,1,1,1,1,1,,1,1
1,1,1,1,1,1,1,1,1,1,1,,1,1,1,1,1,,1,1,1,1,1,,1,1,1,1,1,,1,1
1,1,1,1,1,1,1,1,1,1,1,,1,1,1,1,1,,1,1,1,1,1,,1,1,1,1,1,,1,1
1,1,1,1,1,1,1,1,1,1,1,,1,1,1,1,1,@,1,1,1,1,1,,1,1,1,1,1,,1,1
1,1,1,1,1,1,1,1,1,1,1,,1,1,1,1,1,1,1,1,1,1,1,,1,1,1,1,1,@,1,1
1,1,1,1,1,1,1,1,1,1,1,,1,1,1,1,1,1,1,1,1,1,1,,1,1,1,1,1,1,1,1
1,1,1,1,1,1,1,1,1,1,1,,1,1,1,1,1,1,1,1,1,1,1,,1,1,1,1,1,1,1,1
1,1,1,1,1,1,1,1,1,1,1,,1,1,1,1,1,1,1,1,1,1,1,,1,1,1,1,1,1,1,1
1,1,1,1,1,1,1,1,1,1,1,,1,1,1,1,1,1,1,1,1,1,1,,1,1,1,1,1,1,1,1
1,1,1,1,1,1,1,1,1,1,1,,1,1,1,1,1,1,1,1,1,1,1,,1,1,1,1,1,1,1,1
1,1,1,1,1,1,1,1,1,1,1,@,1,1,1,1,1,1,1,1,1,1,1,,1,1,1,1,1,1,1,1
1,1,1,1,1,1,1,1,1,1,1,1,1,1,1,1,1,1,1,1,1,1,1,,1,1,1,1,1,1,1,1
1,1,1,1,1,1,1,1,1,1,1,1,1,1,1,1,1,1,1,1,1,1,1,,1,1,1,1,1,1,1,1
1,1,1,1,1,1,1,1,1,1,1,1,1,1,1,1,1,1,1,1,1,1,1,,1,1,1,1,1,1,1,1
1,1,1,1,1,1,1,1,1,1,1,1,1,1,1,1,1,1,1,1,1,1,1,@,1,1,1,1,1,1,1,1
1,1,1,1,1,1,1,1,1,1,1,1,1,1,1,1,1,1,1,1,1,1,1,1,1,1,1,1,1,1,1,1