1,1,1,1,1,1,1,1,1,1,1,1,1,1,1,1,1,1,1,1,1,1,1,1,1,1,1,1,1,1,1
1,$R:500,,,,,,,,,,,,@,,,,@,,,,,,,,,,,,,1
1,,1,,1,,1,@,1,,1,,1,0,1,,1,0,1,,1,,1,,1,,1,,1,,1
1,,1,,1,,1,0,1,,1,,1,1,1,,1,1,1,,1,,1,,1,@,1,,1,,1
1,,1,,1,,1,1,1,,1,,1,1,1,,1,1,1,,1,,1,,1,0,1,,1,,1
1,,1,,1,,1,1,1,,1,,1,1,1,,1,1,1,,1,,1,,1,1,1,@,1,,1
1,,1,,1,,1,1,1,,1,,1,1,1,,1,1,1,@,1,,1,,1,1,1,0,1,,1
1,,1,@,1,,1,1,1,,1,,1,1,1,,1,1,1,0,1,,1,,1,1,1,1,1,,1
1,,1,0,1,,1,1,1,@,1,,1,1,1,,1,1,1,1,1,,1,@,1,1,1,1,1,,1
1,,1,1,1,,1,1,1,0,1,,1,1,1,,1,1,1,1,1,,1,0,1,1,1,1,1,,1
1,,1,1,1,,1,1,1,1,1,@,1,1,1,,1,1,1,1,1,@,1,1,1,1,1,1,1,,1
1,,1,1,1,,1,1,1,1,1,0,1,1,1,,1,1,1,1,1,0,1,1,1,1,1,1,1,,1
1,@,1,1,1,,1,1,1,1,1,1,1,1,1,@,1,1,1,1,1,1,1,1,1,1,1,1,1,,1
1,0,1,1,1,,1,1,1,1,1,1,1,1,1,0,1,1,1,1,1,1,1,1,1,1,1,1,1,@,1
1,1,1,1,1,@,1,1,1,1,1,1,1,1,1,1,1,1,1,1,1,1,1,1,1,1,1,1,1,0,1
1,1,1,1,1,0,1,1,1,1,1,1,1,1,1,1,1,1,1,1,1,1,1,1,1,1,1,1,1,1,1