1,0,1,0,1,0,1,0,1,0,1,0,1,0,1,0,1,0,1
0,$D:700,0,,,,,,0,,,,0,,,,,,0
1,,1,,1,0,1,,1,,1,,1,,1,0,1,,1
0,,,,,,0,,,,0,,,,0,,,,0
1,0,1,,1,,1,0,1,,1,0,1,,1,,1,,1
0,,,,0,,,,0,,0,,,,0,,0,,0
1,0,1,,1,0,1,0,1,,1,0,1,0,0,,1,,1
0,,,,0,,,+:0,0,,0,+:0,,,,,0,,0
1,,1,0,1,,1,0,1,,1,0,1,,1,0,1,,1
0,,,,0,,,+:0,0,,,,0,+:0,0,,0,,0
1,0,1,,1,,0,0,1,0,1,,1,0,1,,1,,1
0,,,,,,0,+:0,0,,,,,,0,,,,0
1,,1,0,1,0,1,,0,0,1,0,1,,1,,1,0,1
0,,,,0,,,,0,,,,0,,0,,0,+:0,0
1,,1,0,1,0,1,,1,,1,,1,,1,,1,,0
0,,,,0,,0,,0,,0,,,,0,,,,0
1,,1,0,1,,1,,1,,1,0,1,0,1,0,1,0,1
0,,,,,,,,0,,,,,,,,]:0,@,0
1,0,1,0,1,0,1,0,1,0,1,0,1,0,1,0,1,0,1