1,1,1,1,1,1,1,1,1,1,1,1
1,$R:200,,,,,,,,,2,1
1,1,1,1,1,1,1,1,1,1,,1
1,2,,,,,,,2,1,,1
1,,1,1,1,1,1,1,,1,,1
1,,1,2,,,2,1,,1,,1
1,,1,,1,1,,1,,1,,1
1,,1,,1,@,2,1,,1,,1
1,,1,,1,1,1,1,,1,,1
1,,1,2,,,,,2,1,,1
1,,1,1,1,1,1,1,1,1,,1
1,2,,,,,,,,,2,1
1,1,1,1,1,1,1,1,1,1,1,1