0,0,0,0,0,0,0
0,0,0,A,0,@,0
1,$R:20,,,0,a,0
0,0,0,B,0,0,0
0,0,0,A,0,0,0
0,$R:20,,,0,b,0
0,0,0,B,0,@,0
0,0,0,0,0,0,0